##○○［＃「○○」の場合にインライン注記に変換
#
#圏点と縦中横が重複したら後の注記を無視
#青空《あおぞら》［［＃「青空」に傍点］［＃「青空」は太字］文庫《ぶんこ》［＃「青空文庫」に傍線］
#圏点はfontの中に入れる
#青空［＃「青空」は太字］［＃「青空」に傍点］文庫《ぶんこ》［＃「青空文庫」に傍線］

##kenten 末尾が「点」
に傍点	傍点	傍点終わり
に白ゴマ傍点	白ゴマ傍点	白ゴマ傍点終わり
に丸傍点	丸傍点	丸傍点終わり
に白丸傍点	白丸傍点	白丸傍点終わり
に黒三角傍点	黒三角傍点	黒三角傍点終わり
に白三角傍点	白三角傍点	白三角傍点終わり
に二重丸傍点	二重丸傍点	二重丸傍点終わり
に蛇の目傍点	蛇の目傍点	蛇の目傍点終わり
にばつ傍点	ばつ傍点	ばつ傍点終わり
に×傍点	×傍点	×傍点終わり

の左に傍点	左に傍点	左に傍点終わり
の左に白ゴマ傍点	左に白ゴマ傍点	左に白ゴマ傍点終わり
の左に丸傍点	左に丸傍点	左に丸傍点終わり
の左に白丸傍点	左に白丸傍点	左に白丸傍点終わり
の左に黒三角傍点	左に黒三角傍点	左に黒三角傍点終わり
の左に白三角傍点	左に白三角傍点	左に白三角傍点終わり
の左に二重丸傍点	左に二重丸傍点	左に二重丸傍点終わり
の左に蛇の目傍点	左に蛇の目傍点	左に蛇の目傍点終わり
の左にばつ傍点	左にばつ傍点	左にばつ傍点終わり
の左に×傍点	左に×傍点	左に×傍点終わり

は縦中横	縦中横	縦中横終わり

は見出し	見出し	見出し終わり
は大見出し	大見出し	大見出し終わり
は中見出し	中見出し	中見出し終わり
は小見出し	小見出し	小見出し終わり

は同行大見出し	同行大見出し	同行大見出し終わり
は同行中見出し	同行中見出し	同行中見出し終わり
は同行小見出し	同行小見出し	同行小見出し終わり

は窓大見出し	窓大見出し	窓大見出し終わり
は窓中見出し	窓中見出し	窓中見出し終わり
は窓小見出し	窓小見出し	窓小見出し終わり

に傍線	傍線	傍線終わり
に二重傍線	二重傍線	二重傍線終わり
に鎖線	鎖線	鎖線終わり
に破線	破線	破線終わり
に波線	波線	波線終わり
の左に傍線	左に傍線	左に傍線終わり

に取消線	取消線	取消線終わり
に取り消し線	取り消し線	取り消し線終わり
に二重取消線	二重取消線	二重取消線終わり
に二重取り消し線	二重取り消し線	二重取り消し線終わり

は太字	太字	太字終わり
は斜体	斜体	斜体終わり
はゴシック体	ゴシック体	ゴシック体終わり

は１段階大きな文字	１段階大きな文字	大きな文字終わり
は２段階大きな文字	２段階大きな文字	大きな文字終わり
は３段階大きな文字	３段階大きな文字	大きな文字終わり
は４段階大きな文字	４段階大きな文字	大きな文字終わり
は５段階大きな文字	５段階大きな文字	大きな文字終わり
は６段階大きな文字	６段階大きな文字	大きな文字終わり
は１段階小さな文字	１段階小さな文字	小さな文字終わり
は２段階小さな文字	２段階小さな文字	小さな文字終わり
は３段階小さな文字	３段階小さな文字	小さな文字終わり
は４段階小さな文字	４段階小さな文字	小さな文字終わり
は５段階小さな文字	５段階小さな文字	小さな文字終わり
は６段階小さな文字	６段階小さな文字	小さな文字終わり

は割り注	割り注	割り注終わり
は行右小書き	行右小書き	行右小書き終わり
は行左小書き	行左小書き	行左小書き終わり
は小書き	小書き	小書き終わり
は上付き小文字	上付き小文字	上付き小文字終わり
は下付き小文字	下付き小文字	下付き小文字終わり
は罫囲み	罫囲み	罫囲み終わり
は破線罫囲み	破線罫囲み	破線罫囲み終わり
は破線の罫囲み	破線の罫囲み	破線の罫囲み終わり
は枠囲み	枠囲み	枠囲み終わり
は破線枠囲み	破線枠囲み	破線枠囲み終わり
は横組み	横組み	横組み終わり

は返り点	返り点	返り点終わり

はキャプション	キャプション	キャプション終わり

#青空注記外
は正立	正立	正立終わり

##文字色
は銀色	銀色	銀色終わり
は白鼠色	白鼠色	白鼠色終わり
は白色	白色	白色終わり
は黒地白色	黒地白色	黒地白色終わり
は透明色	透明色	透明色終わり
は灰地透明色	灰地透明色	灰地透明色終わり
は赤色	赤色	赤色終わり
は青色	青色	青色終わり
は水色	水色	水色終わり
は赤紫色	赤紫色	赤紫色終わり
は橙色	橙色	橙色終わり

##背景
は灰背景	灰背景	灰背景終わり
は鼠背景	鼠背景	鼠背景終わり
は銀背景	銀背景	銀背景終わり
は白鼠背景	白鼠背景	白鼠背景終わり
は白背景	白背景	白背景終わり
は透明背景	透明背景	透明背景終わり
は赤背景	赤背景	赤背景終わり
は青背景	青背景	青背景終わり
は水背景	水背景	水背景終わり
は赤紫背景	赤紫背景	赤紫背景終わり
は橙背景	橙背景	橙背景終わり